##################################################################################
#
#
#
#
######
_____#
_____#
_____#
_____#
_____#####
_________#
_________#
_________#
##########
#.............
#........#
#....@...#
#........#
##########
#
#
#