########################################################################################################################################################################################
#............@.........................................................................................................................................................................#
#....................F.................................................................................................................................................................#
#......................................................................................................................................................................................#
#..........obWtY****...................................................................................................................................................................#
#......................................................................................................................................................................................#
#......................................................................................................................................................................................#
#......................................................................................................................................................................................#
#......................................................................................................................................................................................#
#......................................................................................................................................................................................#
#......................................................................................................................................................................................#
#......................................................................................................................................................................................#
#......................................................................................................................................................................................#
#......................................................................................................................................................................................#
#......................................................................................................................................................................................#
#......................................................................................................................................................................................#
#......................................................................................................................................................................................#
#......................................................................................................................................................................................#
#......................................................................................................................................................................................#
#......................................................................................................................................................................................#
#......................................................................................................................................................................................#
#......................................................................................................................................................................................#
#......................................................................................................................................................................................#
#......................................................................................................................................................................................#
#......................................................................................................................................................................................#
#......................................................................................................................................................................................#
#......................................................................................................................................................................................#
#......................................................................................................................................................................................#
#......................................................................................................................................................................................#
#......................................................................................................................................................................................#
#......................................................................................................................................................................................#
#......................................................................................................................................................................................#
#......................................................................................................................................................................................#
#......................................................................................................................................................................................#
#......................................................................................................................................................................................#
#......................................................................................................................................................................................#
#......................................................................................................................................................................................#
#......................................................................................................................................................................................#
#......................................................................................................................................................................................#
#......................................................................................................................................................................................#
#......................................................................................................................................................................................#
#......................................................................................................................................................................................#
#......................................................................................................................................................................................#
#......................................................................................................................................................................................#
#......................................................................................................................................................................................#
#......................................................................................................................................................................................#
#......................................................................................................................................................................................#
########################################################################################################################################################################################